name	location
Brigham and Women's Primary Physicians	4A
Brigham and Women's Primary Physicians	4S
Gastroenterology Associates	4B
Neurology/Sleep Division	4C
Arthritis Center	4D
Rheumatology Center	4D
Infectious Diseases	4F
Allergy	4G
Cardiology	4G
Gastroenterology	4G
Endocrinology	4G
Geriatrics/Senior Health	4G
Hematology	4G
Medical Specialties	4G
Pulmonary	4G
Renal	4G
Headache Center	4H
John R. Graham Headache Center	4H
Neurology	4H
Mohs and Dermatologic Surgery	4J
Men's Health Center	4N
Urology	4N
Doherty Conference Room	Atrium Elevators
Interpreter Services	Hillside Elevators 1
Mary Ann Tynan Conference Rooms	Hillside Elevators 2
Medical Library	Atrium Elevators
Medical Records	Hillside Elevators 1
Sadowsky Conference Room	Hillside Elevators 2
Saslow Conference Room	Atrium Elevators
Social Work	Hillside Elevators 1
