name	title	location
Corrales, Carleton Eduardo	MD	2A
Prince, Anthony	MD	2A
Roditi, Rachel	MD	2A
Carty, Matthew	MD	2B
Caterson, Stephanie	MD	2B
Chun, Yoon Sun	MD	2B
Hajj, Micheline	RN	2B
Halvorson, Eric	MD	2B
Hergrueter, Charles	MD	2B
Ingram, Abbie	PA-C	2B
Lafleur, Emily	PA-C	2B
Lahair, Tracy	PA-C	2B
Sampson, Christian	MD	2B
Cotter, Lindsay	LICSW	Atrium Elevators 2
Doherty, Meghan	LCSW	Hillside Elevators 21
Dowd, Erin	LICSW	Hillside Elevators 22
Eatman, Arlan	LCSW	Atrium Elevators 2
Fromson, John	MD	Hillside Elevators 21
Haimovici, Florina	MD	Hillside Elevators 22
Howard, Neal Anthony	LICSW	Atrium Elevators 2
Humbert, Timberly	MD	Hillside Elevators 21
Keller, Beth	RN, PsyD	Hillside Elevators 22
Lai, Leonard	MD	Atrium Elevators 2
Leone, Amanda	LICSW	Hillside Elevators 21
Mariano, Timothy	MD	Hillside Elevators 22
Matwin, Sonia	PhD	Atrium Elevators 2
Perry, David	LICSW	Hillside Elevators 21
Rodriguez, Claudia	MD	Hillside Elevators 22
Samadi, Farrah	NP	Atrium Elevators 2
Schoenfeld, Paul	MD	Hillside Elevators 21
Stevens, Erin	LICSW	Hillside Elevators 22
Stewart, Carl	MEd, LADC I	Atrium Elevators 2
Trumble, Julia	LICSW	Hillside Elevators 21
Yudkoff, Benjamin	MD	Hillside Elevators 22
Issa, Mohammed 2F	MD	Atrium Elevators 2
