Allergy 	4G
Arthritis Center	4D
Ash, Samuel, MD	4G
	
Bachman, William, MD	4G
Bernstein, Carolyn, MD	4H
Bhasin, Shalender, MD	4N
Bonaca, Marc, MD	4G
Brigham and Women's Primary Physicians	4A/4S
Burch, Rebecca, MD	4H
	
Caplan, Laura, PA-C	4A
Cardet, Juan Carlos, MD	4G
Cardin, Kristin, NP	4G
Cardiology	4G
Chan, Walter, MD	4G
Clark, Roger, DO	4F
Cochrane, Thomas, MD	4H
Conant, Alene, MD	4B
Connell, Nathan, MD	4G
Copello, Maria, MD	4A
Cua, Christopher, MD	4I
	
D'Ambrosio, Carolyn, MD	4G
Dave, Jatin, MD	4G
Drewniak, Stephen, MD	4B
	
Fanta, Christopher, MD	4G
Friedman, Pamela, PsyD, ABPP	4H
	
Gastroenterology  	4G
Gastroenterology Associates 	4B
Geriatrics/Senior Health	4G
Goldman, Jill, MD	4S
	
Headache Center	4H
Healy, Barbara, RN	4A
Hematology	4G
Hentschel, Dirk, MD	4G
Homenko, Daria, MD	4B
Hoover, Paul, MD, PhD	4D
Hsu, Joyce, MD	4G
	
Infectious Diseases 	4F
Interpreter Services	4th Floor
	
John R. Graham Headache Center 	4H
	
Kathrins, Martin, MD	4N
	
Lahive, Karen, MD	4I
Lauretti, Linda, MD	4A
Lilienfeld, Armin, MD	4S
Lilly, Leonard Stuart, MD	4G
Lo, Amy, MD	4B
Loder, Elizabeth, MD	4H
	
Malone, Michael, MD	4N
Mathew, Paul, MD	4H
Matloff, Daniel, MD	4B
McDonald, Michael, MD	4N
McGowan, Katherine, MD	4F
McMahon, Gearoid, MD	4G
McNabb-Balter, Julia, MD 	4B
Medical Specialties  	4G
Men's Health Center	4N
Mohs and Dermatologic Surgery 	4J
Mullally, William, MD	4C
Mutinga, Muthoka, MD	4B
	
Neurology  	4H
Neurology/Sleep Division	4C
Novak, Peter, MD	4C
	
O'Leary, Michael, MD	4N
Oliver, Lynn, RN	4A
Owens, Lisa Michelle, MD	4S
	
Pariser, Kenneth, MD	4D
Parnes, Aric, MD	4G
Pilgrim, David, MD	4C
Preneta, Ewa, MD	4B
Pulmonary  	4G
	
Ramirez, Alberto, MD	4G
Renal  	4G
Rheumatology Center	4D
Rizzoli, Paul, MD	4H
Romano, Keith, MD	4G
Ruff, Christian, MD	4G
Ruiz, Emily, MD	4J
	
Saldana, Fidencio, MD	4G
Schissel, Scott, MD	4G
Schmults, Chrysalyne, MD	4J
Shah, Amil, MD	4G
Sheth, Samira, NP	4G
Smith, Benjamin, MD	4B
Social Work	4th Floor
Steele, Graeme, MD	4N
Sweeney, Michael, MD	4G
	
Tarpy, Robert, MD	4I
Todd, Derrick, MD, PhD	4D
Tucker, Kevin, MD	4G
	
Urology	4N
	
Vardeh, Daniel, MD	4C
Voiculescu, Adina, MD	4G
	
Waldman, Abigail, MD	4J
Walsh Samp, Kathy, LICSW	4A
Weisholtz, Daniel, MD	4C
Welker, Roy, MD	4A
Whitman, Gregory, MD	4C
Wickner, Paige, MD	4G