Rad	Radiology
Preor	
Or	
Recovery	
Lab	
Pulm Lab	
Vasc Lab	
Linen	
Mat Mgnt	
Pre Admit Scrn	Center for Preoperative Evaluation
Card Rehab	
Blood Draw	Blood Draw
Aud	
Special Test	
Endo	GI Endoscopy
Ed	
Emt	
Admit	
Ctrpat	
Mri/Ct	