name	title	location
Alqueza, Arnold	MD	5 South
Altschul, Nomee	PA-C	5 South
Bhattacharyya, Shamik	MD	5 South
Blazar, Phil	MD	5 South
Bluman, Eric	MD	5 South
Bono, Christopher	MD	5 South
Brick, Gregory	MD	5 South
Carleen, Mary Anne	PA-C	5 South
Chahal, Katie	PA-C	5 South
Chiodo, Christopher	MD	5 South
Dawson, Courtney	MD	5 South
Drew, Michael	MD	5 South
Dyer, George	MD	5 South
Earp, Brandon	MD	5 South
Ermann, Joerg	MD	5 South
Fitz, Wolfgang	MD	5 South
Groff, Michael	MD	5 South
Harris, Mitchel	MD	5 South
Hartigan, Joseph	DPM	5 South
Higgins, Laurence	MD	5 South
Isaac, Zacharia	MD	5 South
Issa, Mohammed	MD	5 South
Kramer, Justine	PA-C	5 South
Lu, Yi	MD	5 South
Matzkin, Elizabeth	MD	5 South
McKenna, Robert	PA-C	5 South
Nelson, Ehren	MD	5 South
Pingeton, Mallory	PA-C	5 South
Schoenfeld, Andrew	MD	5 South
Smith, Jeremy	MD	5 South
Taylor, Cristin	PA-C	5 South
Tenforde, Adam	MD	5 South
Vigneau, Shari	PA-C	5 South
Whitlock, Kaitlyn	PA-C	5 South
Yong, Jason	MD	5 South
Zampini, Jay	MD	5 South
Hinton, Nadia	RDN, LDN	5A
Oliveira, Nancy	MS, RDN, LDN	5A
Groden, Joseph	MD	5B
Innis, William	MD	5B
Kessler, Joshua	MD	5B
Mason, William	MD	5B
Paperno, Halie	Au.D, CCC-A	5B
Samara, Mariah	MD	5B
Stone, Rebecca	MD	5B
Barr, Joseph Jr.	MD	5C
Butler, Matthew	DPM	5C
Kornack, Fulton	MD	5C
Savage, Robert	MD	5C
Webber, Anthony	MD	5C
Andromalos, Laura	RD, LDN	5D
Ariagno, Meghan	RD, LDN	5D
Belkin, Michael	MD	5D
Davidson, Paul	PhD	5D
Hartman, Katy	MS, RD, LDN	5D
Irani, Jennifer	MD	5D
Isom, Kellene	MS, RN, LDN	5D
Kenney, Pardon	MD	5D
Kleifield, Allison	PA-C	5D
Matthews, Robert	PA-C	5D
Melnitchouk, Neyla	MD	5D
Nehs, Matthew	MD	5D
Rangel, Erika	MD	5D
Reil, Erin, RD	LDN	5D
Robinson, Malcolm	MD	5D
Sheu, Eric	MD	5D
Shoji, Brent	MD	5D
Spector, David	MD	5D
Tavakkoli, Ali	MD	5D
Vernon, Ashley	MD	5D
Angell, Trevor	MD	5D
Angell, Trevor	MD  5K
Warth, James	MD	5F
Warth, Maria	MD	5F
Balash, Eva	MD	5G
Divito, Sherrie	MD, PhD	5G
Frangos, Jason	MD	5G
Joyce, Eileen	LICSW	5H
Monaghan, Colleen	MD	5H
O'Hare, Kitty	MD	5H
Sharma, Niraj	MD	5H
Cahan, David	MD	5I
Berman, Stephanie	MD	5J
Healey, Michael	MD	5J
Laskowski, Karl	MD	5J
Miatto, Orietta	MD	5J
Nuspl, Kristen	PA-C	5J
Wagle, Neil	MD	5J
Batool-Anwar, Salma	MD, MPH	5K
Boatwright, Giuseppina	MS, RD, LDN	5K
Budhiraja, Rohit	MD	5K
Epstein, Lawrence	MD	5K
Halperin, Florencia	MD	5K
Horowitz, Sandra	MD	5K
Javaheri, Sogol	MD	5K
Johnsen, Jami	MD	5K
Khaodhiar, Lalita	MD	5K
McCarthy, Rita	NP	5K
McDonnell, Marie	MD	5K
McKitrick, Charles	MD	5K
Omobomi, Olabimpe	MD	5K
Palermo, Nadine	MD	5K
Pavlova, Milena	MD	5K
Quan, Stuart	MD	5K
Smith, Colleen	NP	5K
Stephens, Kelly	MD	5K
Wellman, David	MD	5K
White, David	MD	5K
