ORL	2A
Suite 21	2B
Food Services	Food Services
Matmang	Matmang
Pharm	Pharm
Morgue	Morgue
Centerile	Centerile
Bio Engineering	Bio Engineering
Psych Addiction	Outpatient Psych
Psych Inpatient	Inpatient Psych
Hazard Storage	Hazard Storage
Security	Security
Censtrlsup	Censtrlsup
Laundry	Laundry
PT	Physical Therapy
OT	OT
HSKPG	HSKPG
Facilities	Facilities
Mail	Mail
Mech	Mech
