ORL	ORL
Suite 21	Suite21
Food Services	Food Services
Matmang	Matmang
Pharm	Pharm
Morgue	Morgue
Censterile	Censterile
Bio Engineering	Bio Engineering
Psych Addiction	Outpatient Psych (Employee)
Psych Inpatient	Inpatient Psych (Employee)
Hazard Storage	Hazard Storage
Security	Security
Censtrlsup	Censtrlsup
Laundry	Laundry
PT	Physical Therapy (Employee)
OT	OT
Housekeeping	Housekeeping
Facilities	Facilities
Mail	Mail
Mech	Mech
