name	title	location
Byrne, Jennifer	RN, CPNP	3A
Grossi, Lisa	RN, MS, CPNP	3A
Keller, Elisabeth	MD	3A
Malone, Linda	DNP, RN, CPNP	3A
Morrison, Beverly	MD	3A
O'Connor, Elizabeth	MD	3A
Saluti, Andrew	DO	3A
Scheff, David	MD	3A
Stacks, Robert	MD	3A
Tunick, Mitchell	MD	3A
Viola, Julianne	MD	3A
Frangieh, George	MD	3B
Micley, Bruce	MD	3B
Patten, James	MD	3B
Greenberg, James Adam	MD	3C
Miner, Julie	MD	3C
Nadarajah, Sarah	WHNP	3C
Schueler, Leila	MD	3C
Smith, Shannon	MD	3C
